{
  "G": "Ա", "g": "ա",
  "E": "Բ", "e": "բ",
  "D": "Գ", "d": "գ",
  "X": "Դ", "x": "դ",
  "F": "Ե", "f": "ե",
  "B": "Զ", "b": "զ",
  "+": "Է", "=": "է",
  "O": "Ը", "o": "ը",
  "P": "Թ", "p": "թ",
  "Z": "Ժ", "z": "ժ",
  "J": "Ի", "j": "ի",
  "N": "Լ", "n": "լ",
  "#": "Խ", "3": "խ",
  ")": "Ծ", "0": "ծ",
  "I": "Կ", "i": "կ",
  "L": "Հ", "l": "հ",
  "^": "Ձ", "6": "ձ",
  "*": "Ղ", "8": "ղ",
  "Q": "Ճ", "q": "ճ",
  "T": "Մ", "t": "մ",
  "V": "Յ", "7": "յ",
  "H": "Ն", "h": "ն",
  "$": "Շ", "4": "շ",
  "Y": "Ո", "y": "ո",
  "C": "Չ", "c": "չ",
  ":": "Պ", ";": "պ",
  "A": "Ջ", "a": "ջ",
  "%": "Ռ", "5": "ռ",
  "R": "Ս", "r": "ս",
  "S": "Վ", "s": "վ",
  "K": "Տ", "k": "տ",
  "(": "Ր", "9": "ր",
  "&": "Ց", "v": "ց",
  "U": "Ւ", "u": "ւ",
  "W": "Փ", "w": "փ",
  "@": "Ք", "2": "ք",
  "!": "Օ", "1": "օ",
  "~": "Ֆ", "`": "ֆ",
  "]":  "՛", "m": "՝",
  "/": "։", ">": "․",
  "≥": "«", "÷": "»",
  "\"": "(", "}": ")",
  "ø": "[", "π": "]",
  "\u001F": "\t",
  "œ": "“", "∑": "”",
  ".": "՞", "?":"՜",
  " ": " ", "\n": "\n",
  ",": ",",
  "'": "'", "M": "\"",
  "<": "—", "-": "-", "_": "-",
  "µ": "…",

  "º": "0",
  "¡": "1",
  "™": "2",
  "£": "3",
  "¢": "4",
  "∞": "5",
  "§": "6",
  "¶": "7",
  "\u0095": "8",
  "ª": "9"
}